20 20
-----***************
*****-**************
***#*-**************
*****-**************
*****-**************
*****-**************
*****-**************
*****-**************
*****-**************
-****-**************
-****-**************
-****-**************
-****-**************
-****-**************
-****-**************
-****-**************
-****-**********$***
-****-**************
-****-**************
-****-**************
