40 40
************-******************-********
*****#******-****-*************-********
************-****-*************-********
************-****-*************-********
************-****-*************-********
************-****-*************-********
************-****-*************-********
************-****--************-********
************-****--************-********
************-****--************-********
************-****--************-********
************-****--************-********
************-*****-************-********
************-*****-************-********
************-*****-************-********
************-*****-************-********
************-*****-************-********
************-*****-************-********
-----*******-*****-************-********
****-*******-*****-*********************
****-*************-*********************
****-*************-*********************
****-*************-**-------------------
****-*************-*********************
****-*************-*********************
****-*************-*********************
****-*************-*********************
****-*************-*********************
****-*************-*********************
****-*************-*********************
****-*************-*********************
****-*************-*********************
****-*************-*********************
****-*************-*********************
****-*************-*********************
****-*************-*********************
****-*************-*********************
****-*************-***************------
-----*************-**************$******
****-*************-*********************
