50 50
*-**-*******-**-*****-*-*******-*-***-***-***-*-**
*-**********-**-*****-*-*******-*-***-***-***-*-**
*-**********-**-*****-*-*******-*****-***-***-*-**
*-***-******-**-*****-*-*******-*****-***-***-*-**
*-***-******-**-*****-*-*******-*****-***-***-*-**
*-***-******-**-*****-*-*************-***-***-*-**
*-*#*-******-**-*****-*-*************-***-***-*-**
*-***-*********-*****-*-*************-***-***-*-**
*-***-*********-*****-*-*************-***-***-*-**
*-***-*********-*****-*-*************-***-***-*-**
*-***-*********-*****-*-*************-***-***-*-**
*-***-*********-*****-*-****-********-***-***-*-**
*-***-*********-*****-*-****-********-***-***-*-**
*-***-***************-*-****-********-***-***-*-**
*-***-****-**********-*-****-********-***-***-*-**
*-***-****-**********-*-****-********-***-***-*-**
*-***-****-************-****-********-***-***-*-**
*-***-****-************-****-********-***-*****-**
*-***-****-*****************-********-***-*****-**
*-***-****-****************---*******-*-*-*****-**
*-***-****-*****************-*-******-*-*-*****-**
*****-****-*****************-*-******-*-*-*****-**
*****-****-*****************-*-******-*-*-**-**-**
*****-****-****--***********-*-******-*-*-**-**-**
*****-****-******-**********-*-******-*-****-**-**
*****-****-******-**********-*-******-*-****-**-**
-****-****-******-**********-*-******-*-****-**-**
-****-****----------********-*-******-*-****-**-**
-****-****-******-**-*******-*-******-*-****-**-**
-****-****-******-**-*******-*-******-*-****-**-**
-****-****-******-**-*******-*-******-*-****-**-**
-****-****-******-**-*******-*-******-*-****-**-**
-****-****-******-**-*******-*-********-****-**-**
-****-****-******-**-*******-*-********-****-**-**
-****-****-******-**-*******-*-********-****-**-**
-****-****-******-**-*******-*-********-****-**-**
-****-****-******-**-*******-*-********-****-**-**
-****-****-******-**-*******-*-********-****-**-**
-****-****-******-**-*******-*-********-****-**-**
-****-****-******-**-*******-*-********-****-**-**
-****-****-******-**-*******-*-********-****-**-**
-****-***------**-**-*******-*-********-****-*****
-****-****-****-*-**-*******-*-****-***-****-*****
-****-****-****-*-**-*******-*-****-***-****-*****
-****-****-****-*-**-*****----------------**-*****
-****-****-****-*-**-*******-*-****-***-**-*-**$**
-****-****-****-*-**-*******-*-****-***-**-*-*****
-****-****-****-*-**-*******-*-****-***-**-*-*****
-****-****-****-*-**-*******-*-****-***-**-*-*****
-****-****-****-*-**-*****-*-*-****-***-**-*-*****
