10 10
#******-**
*******-**
*******-**
*******-*-
**********
****------
**********
**********
--****----
***-*****$
